0000000000000000000000000000000000000000000000000000000000000000000000
0000001000000000000000000000000000000000000000000000000000000000000000
0000001000000000000000000000000000000000000000000000000000000000000000
0000001000000000000000000000000000000000000000000000000000000000000000
0000001000000000000000000000000000000000000000000000000000000000000000
0000001222220000000000000000000000000000000000000000000000000000000000
0000001000000000000022000000000330000000000000000000000000000000000000
2200001000000000000011000000000000000000000000000000000000000000000000
1155555555555555544000044555555555555555555555555555555555555555555555
1111111111111111111300311111111111111111111111111111111111111111111111
1111111111111111111166111111111111111111111111111111111111111111111111
1111111111111111111111111111111111111111111111111111111111111111111111
1111111111111111111111111111111111111111111111111111111111111111111111
1111111111111111111111111111111111111111111111111111111111111111111111
1111111111111111111111111111111111111111111111111111111111111111111111
1111111111111111111111111111111111111111111111111111111111111111111111
1111111111111111111111111111111111111111111111111111111111111111111111